
NO ./textures/wall_north.xpm
SO ./textures/wall_south.xpm
WE ./textures/wall_west.xpm
EA ./textures/wall_east.xpm

F  220,100,60
C  225,30,120

111111111111
          11
1       0001
1000000 0011
1S0000000001
111111111111
11         1
111111111111
