
NO ./textures/wall_north.xpm

F  220,100              ,  60

SO ./textures/wall_south.xpm


EA ./textures/wall_east.xpm


WE ./textures/wall_west.xpm

C  225            ,   12 4   ,          0



1111
10N1
1111