
NO ./textures/wall_north.xpm

F  220,100,60

SO ./textures/wall_south.xpm


EA ./textures/wall_east.xpm


WE ./textures/wall_west.xpm

C  39           ,  231   ,          245

11111111
10000001
10000001
10000001
10000001
10001001
10000001
10000001
10000001
101000011111111111111111111111111111111111111
100000000000000000000000000000000000000000001
100000000000000000000000000000000000000000001
100000000000000000000000000000000000000000001
100000000000000000000000000000000000000000001
100000000000000111100000000000000000000000001
100000000000000000000000000000000000000000001
100000000000000000000000000000000000000000001
100000000000000000000000000000000000000000001
100000100000000000000000000000000000000000001
100000N10000000000000000000000000000000000001
100000000000000000000000000000000000000000001
100000000000000000000000000000000000000000001
100000000000000000000000000000000000000000001
100000000000000000000000000000000000000000001
100000011111111111111111111111111111111111111
10000001
11111111